NO ./textures/west.xpm
SO ./textures/east.xpm
WE ./textures/south.xpm
EA ./textures/brik.xpm


C 102,119,90
F 90,90,90

        1111111111111111111111111111111
        1000000000110000000000000000001
        1011000001110000000000000000001
        1001000000000000000S0000000000111 
111111111110000011100000000000111100000001
100000000000000011000000000000100011111111         
1000000001000001101001011010010001             
1100000111000101111101111111111000111             
11110111 1110101 101111111111010001             
11111111 1111111 1111111111111111111