NO ./textures/west.xpm
SO ./textures/east.xpm
WE ./textures/south.xpm
EA ./textures/brik.xpm


F 90,90,90
C 102,119,188

111      1111111111111
101      1000000000001
101      1011111111111
101      101
101  1   101
101      101    1
101      101
101      101
1011111111011111111111
1000000000N00000000001
1111111111011111111101
         101       101
         101       101
    1    101       101
         101   1   101
         101       101
111111111101       101
100000000001       101
111111111111       111