NO ./textures/west.xpm
SO ./textures/east.xpm
WE ./textures/south.xpm
EA ./textures/brik.xpm


F 90,90,90
C 102,119,188

                   1111111111111111111111111111111111
                        10000000000000000000000000001
11111111111111111111111110001111101111111101111111011111111111111
11110000001111011100010000001   101      101    11000000011111111
11100000001111111100000000001   101      101    11111111010001001
11110000000000000000000000001111101111111101111111100111000100011
11000000110101000000000010000000000000000000000000100010001110001
10000001000000001100000010E01111101111111101111110100110010000101
10000000010000001101010010001   101      101    10010001111110101
11000001110101001111011110001   101111111101111111000100000000011
11000001110101001111011110001   100000000000000000011111111111111
11110111 1110101 101111010001   11111111111111111111
11111111 1111111 111111111111