NO ./test.xpm
SO ./test.xpm
WE ./test.xpm
EA ./test.xpm


F 255,192,203
C 135,206,235

        1111111111111111111111111
        1000000000110000000000001
        1011000001110000000000001
        1001000000000000000000001
111111111011000001110000000000001
100000000011000001110111111111111
11110111111111011100000010001
11110111111111011101010010001
11000000000000001100000010001
10000000N00000001100000010001
10000000001000001101010010001
1100000111000101111101111000111
11110111 1110101 101111010001
11111111 1111111 111111111111